7
 #####   
 #@. #   
##$.$##  
#  *  ##
#  .$  #
####   #
   #####