10
   ####  
####  ## 
#   $  # 
#  *** # 
#  . . ##
## * *  #
 ##***  #
  # $ ###
  # @ #  
  #####  