5
######## 
#   .  # 
#   $  # 
#   @  #
########
