6
#########
#@ .$   #
#   $   #
#   $.  #
#   .   #
#########