10
#########
#@ ###  #
#  #.#  #
#. #.#  #
#$  $  $#
#      .#
###   ###
  # $ #  
  #   #  
  #####  