 ######### 
 ######### 
 #.@ $   # 
####   * # 
# ########
#         #
#         #
###########