8
########
#  $.  #
#      #
#  ## .#
#@ ## $#
#      #
#  .$  #
########